########
#      #
#      #
#      #
#r #R  #
########
