#########
#r  #  r#
##  #  ##
 #     #
 #     #
##     ##
#       #
#########
