##########
#      ###
# #### ###
# ## # ###
# #R     #
# ## # # #
# #  # # #
# #      #
#r# #### #
##########
